▉ ,▉ ,▉ ,▉ ,▉ ,▉ ,▉ ,▉ ,▉ ,
▒ ,  ,  ,  ,  ,  ,  ,  ,▉ ,
▉ ,▉ ,▉ ,▉ ,▉ ,▉ ,▉ ,  ,▉ ,
▉ ,  ,  ,  ,  ,  ,  ,  ,▉ ,
▉ ,  ,▉ ,▉ ,▉ ,▉ ,▉ ,▉ ,▉ ,
▉ ,  ,  ,  ,  ,  ,  ,  ,▉ ,
▉ ,▉ ,▉ ,▉ ,▉ ,▉ ,▉ ,  ,▉ ,
o ,  ,  ,  ,  ,  ,  ,  ,▉ ,
▉ ,▉ ,▉ ,▉ ,▉ ,▉ ,▉ ,▉ ,▉