▉ ,▉ ,▉ ,▉ ,▉ ,▉ ,▉ ,▉ ,▉ ,▉ ,▉ ,▉ ,▉ ,▉ ,▉ ,
o ,  ,  ,  ,  ,▉ ,  ,  ,  ,▉ ,  ,  ,  ,▉ ,▉ ,
▉ ,  ,▉ ,▉ ,  ,▉ ,  ,▉ ,  ,  ,  ,▉ ,  ,  ,▉ ,
▉ ,  ,▉ ,  ,  ,▉ ,  ,  ,▉ ,  ,▉ ,  ,▉ ,  ,▉ ,
▉ ,  ,▉ ,▉ ,▉ ,▉ ,▉ ,  ,▉ ,  ,  ,  ,▉ ,  ,▉ ,
▉ ,  ,  ,▉ ,  ,  ,▉ ,  ,▉ ,▉ ,  ,▉ ,  ,  ,▉ ,
▉ ,▉ ,  ,▉ ,  ,▉ ,  ,  ,  ,▉ ,▉ ,▉ ,  ,▉ ,▉ ,
▉ ,  ,  ,  ,  ,▉ ,  ,▉ ,  ,  ,▉ ,  ,  ,  ,▉ ,
▉ ,  ,▉ ,▉ ,▉ ,  ,  ,  ,▉ ,  ,▉ ,  ,▉ ,▉ ,▉ ,
▉ ,  ,  ,  ,  ,  ,▉ ,  ,  ,▉ ,  ,  ,  ,  ,▒ ,
▉ ,▉ ,▉ ,▉ ,▉ ,▉ ,▉ ,▉ ,▉ ,▉ ,▉ ,▉ ,▉ ,▉ ,▉ 