▉ ,▉ ,▉ ,▉ ,▉ ,▉ ,▉ ,▉ ,▉ ,▉ ,▉ ,▉ ,▉ ,▉ ,▉ ,▉ ,▉ ,▉ ,▉ ,▉ ,▉ ,▉ ,▉ ,
o ,  ,▉ ,  ,  ,  ,▉ ,  ,▉ ,  ,  ,  ,▉ ,  ,  ,  ,  ,  ,  ,  ,  ,  ,▒ ,
▉ ,  ,  ,  ,  ,▉ ,▉ ,  ,▉ ,▉ ,▉ ,  ,  ,  ,  ,▉ ,▉ ,  ,▉ ,▉ ,▉ ,  ,▉ ,
▉ ,▉ ,▉ ,▉ ,  ,▉ ,  ,  ,  ,  ,▉ ,  ,▉ ,▉ ,▉ ,▉ ,  ,  ,▉ ,  ,▉ ,▉ ,▉ ,
▉ ,  ,▉ ,  ,  ,▉ ,  ,  ,▉ ,  ,▉ ,  ,  ,  ,  ,▉ ,▉ ,  ,▉ ,  ,  ,  ,▉ ,
▉ ,  ,▉ ,▉ ,  ,▉ ,  ,▉ ,▉ ,▉ ,▉ ,  ,  ,▉ ,▉ ,▉ ,  ,  ,  ,  ,▉ ,  ,▉ ,
▉ ,  ,  ,  ,  ,  ,  ,▉ ,  ,  ,▉ ,▉ ,  ,▉ ,  ,  ,  ,▉ ,  ,▉ ,▉ ,▉ ,▉ ,
▉ ,▉ ,▉ ,  ,▉ ,▉ ,  ,  ,  ,▉ ,  ,  ,▉ ,▉ ,  ,▉ ,  ,▉ ,  ,  ,  ,  ,▉ ,
▉ ,  ,  ,  ,▉ ,  ,  ,▉ ,  ,▉ ,▉ ,  ,  ,▉ ,  ,  ,▉ ,▉ ,▉ ,▉ ,▉ ,▉ ,▉ ,
▉ ,▉ ,▉ ,  ,▉ ,  ,  ,▉ ,▉ ,▉ ,  ,  ,▉ ,▉ ,▉ ,  ,  ,  ,  ,  ,▉ ,  ,▉ ,
▉ ,  ,▉ ,▉ ,▉ ,  ,▉ ,▉ ,  ,▉ ,▉ ,  ,  ,  ,▉ ,▉ ,  ,▉ ,▉ ,▉ ,▉ ,  ,▉ ,
▉ ,  ,  ,  ,  ,  ,  ,  ,  ,  ,▉ ,  ,▉ ,  ,  ,▉ ,  ,  ,  ,  ,  ,  ,▉ ,
▉ ,▉ ,  ,▉ ,▉ ,▉ ,▉ ,▉ ,▉ ,  ,  ,  ,▉ ,  ,▉ ,▉ ,▉ ,▉ ,▉ ,  ,▉ ,  ,▉ ,
▉ ,  ,  ,▉ ,  ,  ,  ,  ,▉ ,  ,▉ ,▉ ,▉ ,  ,  ,  ,  ,  ,▉ ,  ,▉ ,▉ ,▉ ,
▉ ,  ,▉ ,▉ ,▉ ,▉ ,▉ ,  ,  ,  ,  ,  ,  ,▉ ,▉ ,  ,▉ ,  ,  ,  ,  ,  ,▉ ,
▉ ,▉ ,  ,▉ ,  ,  ,▉ ,▉ ,▉ ,▉ ,  ,▉ ,  ,  ,▉ ,▉ ,▉ ,  ,▉ ,  ,▉ ,  ,▉ ,
▉ ,  ,  ,  ,▉ ,  ,▉ ,  ,▉ ,  ,  ,▉ ,▉ ,  ,  ,  ,  ,▉ ,▉ ,▉ ,▉ ,▉ ,▉ ,
▉ ,  ,▉ ,  ,  ,  ,  ,  ,  ,  ,  ,▉ ,  ,  ,  ,▉ ,  ,  ,  ,  ,  ,  ,▉ ,
▉ ,▉ ,▉ ,▉ ,▉ ,▉ ,▉ ,▉ ,▉ ,▉ ,▉ ,▉ ,▉ ,▉ ,▉ ,▉ ,▉ ,▉ ,▉ ,▉ ,▉ ,▉ ,▉